#######################################
# Syntax Coloring Map For ESPArto
#######################################

#######################################
# Library (KEYWORD1)
#######################################

ESPArto	KEYWORD1

#######################################
# Datatypes (KEYWORD1)
#######################################

Esparto	KEYWORD1
ESPARTO_TASK_PTR	KEYWORD1
ESPARTO_TIMER	KEYWORD1
ESPARTO_ENC_AUTO	KEYWORD1
ESPARTO_FN_IBOOL	KEYWORD1
ESPARTO_FN_OBOOL	KEYWORD1
ESPARTO_FN_SV	KEYWORD1
ESPARTO_FN_VOID	KEYWORD1
ESPARTO_FN_COUNT	KEYWORD1
ESPARTO_FN_GRAPH	KEYWORD1

#######################################
# Methods and Functions (KEYWORD2)
#######################################
addCmd	KEYWORD2
alexaInUse	KEYWORD2
at	KEYWORD2
cancel	KEYWORD2
cancelAll	KEYWORD2
CircularLatch	KEYWORD2
clockTime	KEYWORD2
configItemExists	KEYWORD2
CountingLatch	KEYWORD2
daily	KEYWORD2
Debounced	KEYWORD2
decConfigInt	KEYWORD2
DefaultInput	KEYWORD2
DefaultOutput	KEYWORD2
device	KEYWORD2
digitalWrite	KEYWORD2
Encoder	KEYWORD2
EncoderAuto	KEYWORD2
every	KEYWORD2
everyRandom	KEYWORD2
factoryReset	KEYWORD2
Filtered	KEYWORD2
finishEarly	KEYWORD2
finishIf	KEYWORD2
finishNow	KEYWORD2
flashLED	KEYWORD2
flashMorse	KEYWORD2
flashMorseText	KEYWORD2
flashPattern	KEYWORD2
flashPWM	KEYWORD2
getConfig	KEYWORD2
getConfigInt	KEYWORD2
getConfigstring	KEYWORD2
getDate	KEYWORD2
getPinCount	KEYWORD2
getPinValue	KEYWORD2
getRawTimestamp	KEYWORD2
getSpeed	KEYWORD2
graph	KEYWORD2
hasRTC	KEYWORD2
incConfigInt	KEYWORD2
invokeCmd	KEYWORD2
isFlashing	KEYWORD2
isPinThrottled	KEYWORD2
Latching	KEYWORD2
logEvent	KEYWORD2
logicalWrite	KEYWORD2
loop	KEYWORD2
minusEqualsConfigInt	KEYWORD2
MultiStage	KEYWORD2
nTimes	KEYWORD2
nTimesRandom	KEYWORD2
once	KEYWORD2
onceRandom	KEYWORD2
Output	KEYWORD2
parseTime	KEYWORD2
plusEqualsConfigInt	KEYWORD2
Polled	KEYWORD2
printf	KEYWORD2
println	KEYWORD2
publish	KEYWORD2
publish_v	KEYWORD2
pulseLED	KEYWORD2
queueFunction	KEYWORD2
randomTimes	KEYWORD2
randomTimesRandom	KEYWORD2
Raw	KEYWORD2
reboot	KEYWORD2
reconfigurePin	KEYWORD2
repeatWhile	KEYWORD2
repeatWhileEver	KEYWORD2
Reporting	KEYWORD2
Retriggering	KEYWORD2
secSinceMidnight	KEYWORD2
setConfig	KEYWORD2
setConfigInt	KEYWORD2
setConfigstring	KEYWORD2
state	KEYWORD2
stopLED	KEYWORD2
strTime	KEYWORD2
subscribe	KEYWORD2
throttlePin	KEYWORD2
Timed	KEYWORD2
toggle	KEYWORD2
umsSinceMidnight	KEYWORD2
upTime	KEYWORD2
useAlexa	KEYWORD2
vBar	KEYWORD2
wifiConnected	KEYWORD2
onClockTick	KEYWORD2
onConfigItemChange	KEYWORD2 
onFactoryReset	KEYWORD2     
onMqttConnect	KEYWORD2      
onMqttDisconnect	KEYWORD2   
onOtaEnd	KEYWORD2
onOtaProgress	KEYWORD2
onOtaStart	KEYWORD2
onPinConfigChange	KEYWORD2  
onReboot	KEYWORD2          
onRTC	KEYWORD2
onTimeSync	KEYWORD2
onWiFiConnect	KEYWORD2      
onWiFiDisconnect	KEYWORD2   
setupHardware	KEYWORD2      
userLoop	KEYWORD2 
#######################################
# Constants (LITERAL1)
#######################################
OFF	LITERAL1
ON	LITERAL1

